S.##.....T
.TT#..###.
#.###E###E
#.E...###.
###T#####G
